type bad
height 15
width 15
map
TTTTTTTTTTTTTTT
T...T......T..T
T.T.T.TTT.TT.TT
T.T.T.T...T..TT
T.T.T.T.TTT.T.T
T......T....T.T
T.TTTT.T.TTTT.T
T....T.T.T....T
TTTT..T.T.TTTTT
T..TT.T.T.....T
T.....T.TTT.T.T
TT.TTTT.....T.T
T......TTT.TT.T
T.TTTTTT.T....T
TTTTTTTTTTTTTTT
